1,1,1,1,1,1
1,3,0,2,1,1
1,0,0,0,0,1
1,1,1,0,1,1
1,0,3,2,4,1
1,1,1,1,1,1
